111111111111111
100000000000001
101111111111101
101000000000101
101011111110101
101010000010101
101010000010101
101000000010101
101010000010101
101010000010001
101011111110101
101000000000101
101111111111101
100000000000001
111111111111111