111111111111111
100000000000001
100111110111111
100100000000001
100111111111101
100100000000001
100101111111111
100000000000001
101111111111101
101000000010101
100010000010001
101010000000101
101111111111101
100000000000001
111111111111111