111111111111111111
100000000000000001
100111110111111001
100100000000001001
100111111111101001
100100000000001001
100101111111111001
100000000000000001
101111110011111101
101000000000010101
100010000000010001
101010000000000101
101111110011111101
100000000000000001
111111111111111111