##################
#11#1111111111111#
#######1#######11#
#55#1111111111#11#
#55##########1#11#
#55#1111111111#11#
#55#1##########11#
#1111111111111111#
#1######33######1#
#1#1111111111#1#1#
#111#11111111#111#
#1#1#1111111111#1#
#1######33########
#11111111111111#1#
##################